#-#####
#-#---#
#-#---#
#----##
####-##
#######