#-################
#-################
#-################
#-################
#-###-############
#-#---############
#---##############
#-################