#-#####
#*#---#
#-#---#
#@---##
#-##-##
#######