#--#######
##########
###-######
##########
##########
####-#####
##########